abiiz	habis
abis	habis
adzan	azan
agusyudhoyono	agus yudhoyono
aja	saja
ajah	saja
ak	aku
akankh	akankah
akn	akan
akuntable	akuntabel
alasanya	alasannya
ama	sama
ambulan	ambulans
ame	sama
amiin	amin
ampe	sampai
amrik	amerika
ana	saya
ane	saya
anehhh	aneh
anie	anies
antutias	antusias
apalg	apalagi
apaqa	apakah
artix	artinya
as	amerika serikat
aseng	asing
ato	atau
aurah	aura
aq	aku
ayoo	ayo
ayuk	ayo
bae	aja
bagaiamana	bagaimana
baguus	bagus
bak	bagaikan
banget	sangat
banyangkan	bayangkan
bareng	bersama-sama
baswedam	baswedan
bazerp	buzzerrp
becus	mampu
begook	bego
bejad	bejat
belom	belum
bener	benar
bernopol	bernomor polisi
berfikir	berpikir
berhub	berhubungan
berkat	karena
bgini	begini
bgitu	begitu
bgimn	bagaimana
bhineka	bineka
biar	supaya
bikin	buat
bliau	beliau
blingsatan	tidak tenang
blm	belum
bnr	benar
bnyk	banyak
bohir	pemilik modal
bokeb	film porno
bokep	film porno
bongpret	cebong kampret
bontot	bungsu
bp	bapak
bpk	bapak
brbekas	berbekas
brsma	bersama
bs	bisa
bsr	besar
bu	ibu
buyud	buyut
buzeer	buzzer
byk	banyak
ca	calon
cacimaki	caci maki
cape	lelah
capek	lelah
caprescawapres	capres cawapres
caritau	cari tahu
cb	coba
cdngsr	cengar
cepet	cepat
cepetan	cepat
cewe	wanita
cewek	wanita
chainis	chinese
clingag	celingak
clingug	celinguk
congres	congress
cos	karena
cowo	pria
cowok	pria
coz	karena
cuan	untung
dah	sudah
dapet	dapat
deadline	tenggat waktu
dengam	dengan
deviden	dividen
dg	dengan
dgn	dengan
dgendong	digendong
dgn 	dengan
diapresiasia	diapresiasi
dicacimaki	dicaci maki
didlm	di dalam
didzalimi	dizalimi
diem	diam
digubris	dipedulikan
dikelarin	diselesaikan
diketuai	dipimpin
diluar	di luar
dilupain	dilupakan
dimasa	di masa
dimatiin	dimatikan
dimiki	dimiliki
dipasar	di pasar
dirubuhkan	dirobohkan
diseyumin	disenyumin
ditahun	di tahun
ditangan	di tangan
diutangin	mengutangi
dll	dan lain lain
dlm	dalam
dmn	dimana
dmna	dimana
dng	dengan
dngn	dengan
doain	doakan
doang	saja
doank	saja
doyan	suka sekali
dpet	dapat
dri	dari
drpd	daripada
duit	uang
duid	uang
dwngan	dengan
eid	id
elu	kamu
emak	mak
emaknya	maknya
emang	memang
endonesah	indonesia
engk	tidak
eneg	enek
entar	nanti
ente	kamu
expos	ekspos
fadilitas	fasilitas
faham	paham
feb	februari
fi	di
ga	tidak
gabisa	tidak bisa
gak	tidak
gaabis	tidak habis
gaes	guys
gais	guys
gak	tidak
ganjaris	ganjarist
ganjarpranowo	ganjar pranowo
gausah	tidak usah
gemoy	gemas
geng	gerombolan
ges	guys
ghibah	gibah
ghibahin	menggibahi
gibahin	menggibahi
gimana	bagaimana
gini	begini
gitu	begitu
gitulah	begitulah
gk	tidak
goblog	goblok
gua	aku
gub	gubernur
gue	aku
gw	aku
headtrick	hattrick
heduuh	aduh
hektar	hektare
hits	hit
hoax	hoaks
hrs	harus
idulfitri	idul fitri
ied	id
ihlaskan	ikhlaskan
ijasah	ijazah
ijasahnya	ijazahnya
iklas	ikhlas
iku	itu
ilang	hilang
indo	indonesia
indonesai	indonesia
insha	insya
inshaallah	insyaallah
inssallah	insyaallah
jamiman	jaminan
jd	jadi
jdi	jadi
jendral	jenderal
jg	juga
jgn	jangan
jkt	jakarta
jkw	jokowi
jln	jalan
jokowidodo	joko widodo
jt	juta
kaan	kan
kab	kabupaten
kabinetm	kabinet
kacian	kasihan
kaga	tidak
kale	kali
kalo	kalau
kangen	rindu
kana	karena
kans	kesempatan
karempeng	kurus
karepe	keinginan
karir	karier
karna	karena
kasi	kasih
kasian	kasihan
kau	kamu
kayak	seperti
kayaknya	sepertinya
kcuali	kecuali
kdepannya	kedepannya
kec	kecamatan
kedepan	ke depan
kedepannya	ke depannya
kejuaran	kejuaraan
kek	seperti
keknya	sepertinya
kemana	ke mana
kembli	kembali
kemaren	kemarin
kemhan	kemenhan
kenyaman	kenyamanan
kepemipinan	kepemimpinan
kepepimpinan	kepemimpinan
kerempeng	kurus
kerena	karena
kerenn	keren
kesel	kesal
ketemu	bertemu
keterngn	keterangan
ketulungan	tertolong
kgt	kaget
khabar	kabar
kibul	bohong
kl	kalau
klu	kalau
klo	kalau
kmp	kampung
kmu	kamu
kmren	kemarin
kmrn	kemarin
knapa	kenapa
komit	komitmen
konkrit	konkret
kopasus	kopassus
koq	kok
kpd	kepada
kpntingan	kepentingan
krena	karena
krn	karena
krna	karena
ku	aku
latarbelakang	latar belakang
lbh	lebih
lemb	lembaga
lemparaan	lemparan
lg	lagi
lgi	lagi
lha	lah
liat	lihat
link	tautan
lo	kamu
loby	lobi
lobby	lobi
loe	kamu
lonbok	lombok
lu	kamu
maannttaap	mantap
macem	macam
madati	memadati
makin	semakin
mantaap	mantap
mantep	mantap
mar	maret
marchandise	merchandise
mastinya	mestinya
matiin	mematikan
melaksnakan	melaksanakan
memonitoring	memonitor
menanges	menangis
mending	lebih baik
mengkampanyekan	mengampanyekan
mengunjunhi	mengunjungi
menha	menhan
mensejahterakan	menyejahterakan
menyelenggarakn	menyelenggarakan
mileniaal	milenial
milyar	miliar
minya	misinya
miq	mik
mjdi	menjadi
mkin	semakin
mksudnya	maksudnya
mlm	malam
mbuat	membuat
mngecek	mengecek
mnghadapi	menghadapi
mnjdi	menjadi
mnjadi	menjadi
mnyesatkn	menyesatkan
mo	mau
moga	semoga
moment	momen
mosok	masa
mpe	sampai
mrk	mereka
msh	masih
mu	kamu
mungking	mungkin
musu	musuh
mutar	putar
muter	putar
nanggapi	menanggapi
nangis	menangis
ngak	tidak
ngambek	marah
ngarahnya	mengarahnya
ngaruh	memengaruhi
ngeles	berkilah
ngerti	mengerti
ngga	tidak
nggak	tidak
nggk	tidak
ngibul	berbohong
ngibulin	membohongi
ngidam	mengidam
ngikutin	mengikuti
ngimpi	mimpi
ngk	tidak
ngomong	omong
ngumbar	mengumbar
ngusung	mengusung
ni	ini
nih	ini
nii	ini
ntar	nanti
nti	nanti
nyadar	sadar
nyalonin	mencalonkan
nyapa	menyapa
obok	kobok
ogah	tidak mau
ok	oke
ono	ada
onta	unta
opo	apa
org	orang
pak	bapak
paki	pakai
pake	pakai
palingpas	paling cocok
pantes	pantas
parawangsa	parawansa
pas	cocok
pd	percaya diri
pdemokrat	partai demokrat
peabowo	prabowo
pedeipe	pdip
pedeipeh	pdip
pejuhwang	pejuang
pelaksaan	pelaksanaan
pemiku	pemilu
pen	ingin
pencintraan	pencitraan
penghianat	pengkhianat
perduli	peduli
perumusyawaratan	permusyawarahan
pertahana	pertahanan
pesen	pesan
pesepakbola	pesepak bola
pilihanny	pilihannya
piling	perasaan
pilres	pilpres
pingin	ingin
pinter	pintar
piplres	pilpres
plis	mohon
pmbela	pembela
pngalamn	pengalaman
pnjng	panjang
pny	punya
politk	politik
pondasi	fondasi
pooling	polling
populo	populi
praboowo	prabowo
prabowosubianto	prabowo subianto
pres	presiden
president	presiden
pressiden	presiden
prilaku	perilaku
prnh	pernah
propinsi	provinsi
ptesiden	presiden
ramadhan	ramadan
rame	ramai
rasyd	rasyid
respon	respons
ri	republik indonesia
riziek	rizieq
rkyt	rakyat
roses	proses
rosyid	rasyid
rp	rupiah
saben	setiap
saking	karena sangat
sallam	salam
sampe	sampai
sangsi	sanksi
sbg	sebagai
sbuah	sebuah
sbutan	sebutan
sdari	sedari
sdh	sudah
sdah	sudah
sebahagian	sebagian
seberatx	seberat
sebgai	sebagai
sekedar	sekadar
selamaanya	selamanya
seneng	senang
sepakbola	sepak bola
seroang	seorang
setop	stop
sgt	sangat
sholeh	saleh
sholih	saleh
shrsnya	seharusnya
sih	memang
silahkan	silakan
sinkronisasi	menyinkronkan
sirambut	si rambut
sj	saja
sjarah	sejarah
skrg	sekarang
slalu	selalu
slama	selama
sllu	selalu
slma	selama
sm	sama
smg	semoga
smoga	semoga
smp	sampai
smua	semua
sngt	sangat
sngat	sangat
sok	berlagak
sopo	siapa
sprt	seperti
spt	seperti
spy	supaya
stabilisasi	menstabilkan
strategist	strategis
sumatera	sumatra
superkuat	super kuat
survey	survei
sy	saya
syetan	setan
syurga	surga
sya	saya
syap	siap
taik	tahi
tamba	tambah
tar	nanti
tau	tahu
taun	tahun
tbtb	tiba-tiba
tdak	tidak
tdk	tidak
tegoklah	tengoklah
telpon	telepon
temanmya	temannya
temen	teman
temenan	berteman
tenagah	tengah
tercover	terkover
terelakan	terelakkan
terimakasih	terima kasih
tetiba	tiba-tiba
tgl	tanggal
thanx	thanks
thn	tahun
tidk	tidak
tp	tapi
tpi	tapi
tranaparan	transparan
trus	terus
tsb	tersebut
tu	itu
tuh	itu
tuk	untuk
tulung	tolong
tw	tahu
uda	sudah
udah	sudah
udeh	sudah
udh	sudah
untu	untuk
ustadz	ustaz
utk	untuk
vidio	video
walopun	walaupun
wkt	waktu
wlau	walau
wong	orang
yamg	yang
yasudah	ya sudah
yaudah	ya sudah
ye	ya
yg	yang
ygy	ya guys ya
yoi	iya
yth	yang terhormat
yu	ayo
yuk	ayo
zolomi	zalimi
ztuhan	tuhan